WALL=1;2;3;4;5;6
FLOOR=0;a;b;c;d;D;X;Y
CEILING=0;a;d;D;X
TELEP=[dD][XY]

                     11111111111111
                     10000000000001
                     600E0000000001
                     10000000000001
        4444444444444100000000000d1
       4cccccccccccc331111111111121
       4cccccccccccc3355555555555255555555
       4cccccccccccc55aaaaaaaaaaaDaaaaaaaa5
       4ccccccccccbbY2Xaaaaaaaaaaaaaaaaaaa5
       4cccccccccccc55aaaaaaaaaaaaaaaaaaaa5
       4cccccccccccc35aaaaaaaaaaaaaaaaaaaa5 
        4444444444444 55555555555555555555
