WALL=1;2;3;4;5;8;6
FLOOR=0;c;t;T;O;o;l;L;9;7
CEILING=0;o
TELEP=[Tt][oO][lL]


111111111111111
1l00000000000001
1000000000000001
1E000000000000001
111111111111111001
              1001
              1001
              10011111111
   11111111111100000000001
   1000000000000011111111
   1T11111111110000000001
    1          111111111111

222222222222222  
2999999999999992    
2939999t99999392     3
2999999999999992    393
2999399999939992   39993
2999999999999992  3999993
2999993993999992 399999993
299999999999999239999999993
2999939999399992999999999992
2999399339993992999999999992
29992939O3222222999999999992
2922299992     2399999999992
2922222222222222999999999992
2999999999999999999999999992
2222222222222222222222222222
  
   44545454
   5cccccc4
   4cccccc5
   5cccccc4
   4cccccc5
   5cccccc4
   4454o454
       44

88888
877778
8L7776
877778
88888