WALL=1;2;3;4
FLOOR=0;c;t;T;O;o
CEILING=0
TELEP=[Tt][Ss]

111111111111111
1E00000000000001
10000000000000001
111111111111111001
              1001
              1001
              10011111111
   11111111111100000000001
   1000000000000011111111
   1T11111111110000000001
    1          111111111111


222222222222222
2000000000000002
2030000t00000302
2000000000000002
2000300000030002
2000000000000002
2000003003000002
2000030000300002
2003000330003002
22222030O3222222
    200002
    222222

   44444444
   4cccccc4
   4cccccc4
   4cccccc4
   4cccocc4
   4cccccc4
   44444444