NO ./path_to_the_north_texture
SO ./path_to_the_south_texture
WE ./path_to_the_west_texture
EA ./path_to_the_east_textures_of_doom
F 111,1,11
C 225,30,0

1111111111111111111111111
10000000000000000000000001111111
1100111011000001110000000000001
100000000011000001110111111111111
11110111111111011100000010001
11110111101111011101000000001
11000000110101011100001000001
10000000000000001100N00000001
10000000000000001101010000001
1100000111010101111101111000111
11110111 1110101 101111010001
11111111 1111111 111111111111

111111
100001
100011
1111
