NO textures/map/platypus.xpm
SO textures/map/shrekdonkey.xpm
WE textures/map/sonic.xpm
EA textures/map/wooper_art_nicer.xpm




F 230,200,200              
C 200,200,230

1111111111111111111111111
10000000000000000000000001111111
1100111011000001110000000000001
100000000011000001110111111111111
11110111111111011100000010001
11110111101111011101000000001
11000000110101011100001000001
1000N000000000001100000000001
10000000000000001101010000001
1100000111010101111101111000111
11110111 1110101 101111010001
11111111 1111111 111111111111

1111111111111111111111111111111111111111
1000000000000000000000000000000000000001             1111111111111111111111111111
1000000000000000000000000000000000000001             1000000000000000000000000001
1000000000000000000000000000000000000001             1000000000000000000000000001
1000111111111111111111111111111111111111             1000001000000000000000000001
100011                                               1000000000000000000000100001
100011                                               1000000000000000000000000001
100011                                               1000000000000000000000000001
100011                                               1000000000000000000000000001
100011                                               1000000000000000000000000001
100011                                               1000000000000000000000000001
100011                                               1000001110000000000000000001
100011                                               1000000000000000000000000001
100011                                               1000000000000000000000000001
100011                                               1111111111111111111111111111
100011
100011
100011
111111
