NO textures/sonic.xpm
SO textures/wooper_art_nicer.xpm
WE textures/shrekdonkey.xpm
EA textures/platypus.xpm

F 164,169,20
C 153,204,255

111111111111111111111
101000001000000000001
101010101011111110001
100010100010000010001
111110000000001011101
100000000000001000001
10110000S000001111111
101000000000000000101
101000000000011110101
101010001000000010101
101110101010101010101
100000101010001010001
111111111111111111111

