NO ./path_to_the_north_texture
SO ./path_to_the_south_texture
WE ./path_to_the_west_texture
EA ./path_to_the_east_textures_of_doom
F 111,1,11
C 225,30,0

111111111
10000001111111111111111111
10000000000000000000000001
111111100000000N0000000001
       1000000000000000001
       1000001111111111111
       111111

	111111
	100001
	11111