1111111111111111111111111
10000000000000000000000001111111
1100111011000001110000000000001
100000000011000001110111111111111
11110111111111011100000010001
11110111101111011101000000001         11111
11000000110101011100001000001         10001
10000000000000001100E00000001         10011111111
10000000000000001101010000001      111111
1100000111010101111101111000111
11110111 1110101 101111010001
11111111 1111111 111111111111

111111
100001
100011
1111


