111111111111
111111100001111
11111100101000011
11111111000111111111
11111111101111011110111111
101010100000000110101011
100000000N0000000000000011
111111100000111111111111
11111111101111111111111
11111111000111111111111
11111111101111111111111
1111111101011111111111
11111111111111111
