1111111111
100000000011
111101111111111
1111011110111101
11000000110101011
1000N0000000000011
111111111111111111
