WALL=1
FLOOR=0;a;b;2
CEILING=0

            1111111111111111111111111111111111111
            1222222222222222222222222222222222221
            12aaaaaaaaaaaaaaaaaaaaaaaaaaaaaaaaa21
            12aaaaaaaaaaaaaaaaaaaaaaaaaaaaaaaaa21
            12aaaaaaaaaaaaaaaaaaaaaaaaaaaaaaaaa21
            12aaaaaaaaaaaaaaaaaaaaaaaaaaaaaaaaa21
1111111111111aaaaaaaaaaaaaaa22aaaaaaaaaaaaaaaa211
1000000000001aaaaaaaaaaaaaaa22aaaaaaaaaaaaaaaa21
1000100000001aaaaaaaaaaaaaaaaaaaaaaaaaaaaaaaaa21
1001000000000bbbaaaaaaaaaaaaaaaaaaaaaaaaaaaaaa21
1000100000001aaaaaaaaaaaaaaaaaaaaaaaaaaaaaaaaa21
10000E0000001aaaaaaaaaaaaaaaaaaaaaaaaaaaaaaaaa21
1000000000001aaaaaaaaaaaaaaaaaaaaaaaaaaaaaaaaa21
111111111111122222222222222222222222222222222221
111111111111111111111111111111111111111111111111
